############
#    #     ###
#    #       #
#    # ####  #
#.$    1 ##  #
#    # #    ##
###### ##    #
  #          #
  #.$ 2#     #
  ############