############
#..  #     ###
#..  # $  $  #
#..  #$####  #
#..    1 ##  #
#..  # #  $ ##
###### ##$ $ #
  # $  $ $ $ #
  #    #     #
  ############
