############
#..  #     ###
#..  # $  $  #
#..  #$####  #
#..    1 ##  #
#..  # #  $ ##
###### ##$ $ #
  # $  $ $ $ #
  #   2#     #
  ############